기준일,확진자수,누적확진자수,사망자수,누적사망자수,누적의심신고검사자수
2020-01-20,1,1,0,0,4
2020-01-21,0,1,0,0,15
2020-01-22,0,1,0,0,21
2020-01-23,0,1,0,0,25
2020-01-24,1,2,0,0,29
2020-01-25,0,2,0,0,47
2020-01-26,1,3,0,0,56
2020-01-27,1,4,0,0,84
2020-01-28,0,4,0,0,137
2020-01-29,0,4,0,0,208
2020-01-30,3,7,0,0,275
2020-01-31,4,11,0,0,335
2020-02-01,1,12,0,0,371
2020-02-02,3,15,0,0,429
2020-02-03,0,15,0,0,490
2020-02-04,1,16,0,0,607
2020-02-05,5,21,0,0,714
2020-02-06,3,24,0,0,885
2020-02-07,0,24,0,0,1130
2020-02-08,0,24,0,0,1701
2020-02-09,3,27,0,0,2340
2020-02-10,1,28,0,0,2776
2020-02-11,0,28,0,0,3629
2020-02-12,0,28,0,0,5074
2020-02-13,0,28,0,0,5797
2020-02-14,0,28,0,0,6854
2020-02-15,0,28,0,0,7519
2020-02-16,2,30,0,0,7919
2020-02-17,0,30,0,0,8171
2020-02-18,2,32,0,0,9265
2020-02-19,34,66,0,0,10411
2020-02-20,16,82,1,1,12161
2020-02-21,74,156,0,1,14816
2020-02-22,190,346,2,3,19621
2020-02-23,210,556,0,3,22633
2020-02-24,207,763,4,7,28615
2020-02-25,130,893,1,8,36716
2020-02-26,253,1146,3,11,46127
2020-02-27,449,1595,1,12,57990
2020-02-28,427,2022,1,13,70940
2020-02-29,909,2931,3,16,85693
2020-03-01,595,3526,1,17,96985
2020-03-02,686,4212,6,23,109591
2020-03-03,600,4812,5,28,125851
2020-03-04,516,5328,4,32,136707
2020-03-05,438,5766,3,35,146541
2020-03-06,518,6284,7,42,164740
2020-03-07,483,6767,2,44,178189
2020-03-08,367,7134,6,50,188518
2020-03-09,248,7382,1,51,196618
2020-03-10,131,7513,3,54,210144
2020-03-11,242,7755,6,60,222395
2020-03-12,114,7869,6,66,234998
2020-03-13,110,7979,1,67,248647
2020-03-14,107,8086,5,72,261335
2020-03-15,76,8162,3,75,268212
2020-03-16,74,8236,0,75,274504
2020-03-17,84,8320,6,81,286716
2020-03-18,93,8413,3,84,295647
2020-03-19,152,8565,7,91,307024
2020-03-20,87,8652,3,94,316664
2020-03-21,147,8799,8,102,327509
2020-03-22,98,8897,2,104,331780
2020-03-23,64,8961,7,111,338036
2020-03-24,76,9037,9,120,348582
2020-03-25,100,9137,6,126,357896
2020-03-26,104,9241,5,131,364942
2020-03-27,91,9332,8,139,376961
2020-03-28,146,9478,5,144,387925
2020-03-29,105,9583,8,152,394141
2020-03-30,78,9661,6,158,398902
2020-03-31,125,9786,4,162,410564
2020-04-01,101,9887,3,165,421547
2020-04-02,89,9976,4,169,431743
2020-04-03,86,10062,5,174,443273
2020-04-04,94,10156,3,177,455032
2020-04-05,81,10237,6,183,461233
2020-04-06,47,10284,3,186,466804
2020-04-07,47,10331,6,192,477304
2020-04-08,53,10384,8,200,486003
2020-04-09,39,10423,4,204,494711
2020-04-10,27,10450,4,208,503051
2020-04-11,30,10480,3,211,510479
2020-04-12,32,10512,3,214,514621
2020-04-13,25,10537,3,217,518743
2020-04-14,27,10564,5,222,527438
2020-04-15,27,10591,3,225,534552
2020-04-16,22,10613,4,229,538775
2020-04-17,22,10635,1,230,546463
2020-04-18,18,10653,2,232,554834
2020-04-19,8,10661,2,234,559109
2020-04-20,13,10674,2,236,563035
2020-04-21,9,10683,1,237,571014
2020-04-22,11,10694,1,238,577959
2020-04-23,8,10702,2,240,583971
2020-04-24,6,10708,0,240,589520
2020-04-25,10,10718,0,240,595161
2020-04-26,10,10728,2,242,598285
2020-04-27,10,10738,1,243,601660
2020-04-28,14,10752,1,244,608514
2020-04-29,9,10761,2,246,614197
2020-04-30,4,10765,1,247,619881
2020-05-01,9,10774,1,248,623069
2020-05-02,6,10780,2,250,627562
2020-05-03,13,10793,0,250,630973
2020-05-04,8,10801,2,252,633921
2020-05-05,3,10804,2,254,640237
2020-05-06,2,10806,1,255,643095
2020-05-07,4,10810,1,256,649388
2020-05-08,12,10822,0,256,654863
2020-05-09,18,10840,0,256,660030
2020-05-10,34,10874,0,256,663886
2020-05-11,35,10909,0,256,668492
2020-05-12,27,10936,2,258,680890
2020-05-13,26,10962,1,259,695920
2020-05-15,56,11018,1,260,726747
2020-05-16,19,11037,2,262,740645
2020-05-17,13,11050,0,262,747653
2020-05-18,15,11065,1,263,753211
2020-05-19,13,11078,0,263,765574
2020-05-20,32,11110,0,263,776433
2020-05-21,12,11122,1,264,788684
2020-05-22,20,11142,0,264,802418
2020-05-23,23,11165,2,266,814420
2020-05-24,25,11190,0,266,820289
2020-05-25,16,11206,1,267,826437
2020-05-26,19,11225,2,269,839475
2020-05-27,40,11265,0,269,852876
2020-05-28,79,11344,0,269,868666
2020-05-29,58,11402,0,269,885120
2020-05-30,39,11441,0,269,902901
2020-05-31,27,11468,1,270,910822
2020-06-01,35,11503,1,271,921391
2020-06-02,38,11541,1,272,939851
2020-06-03,49,11590,1,273,956852
2020-06-04,39,11629,0,273,973858
2020-06-05,39,11668,0,273,990960
2020-06-06,51,11719,0,273,1005305
2020-06-07,57,11776,0,273,1012769
2020-06-08,37,11813,0,273,1018214
2020-06-09,38,11851,1,274,1035997
2020-06-10,50,11901,2,276,1051972
2020-06-11,45,11946,0,276,1066888
2020-06-12,56,12002,1,277,1081486
2020-06-13,48,12050,0,277,1094704
2020-06-14,34,12084,0,277,1100327
2020-06-15,37,12121,0,277,1105719
2020-06-16,34,12155,1,278,1119767
2020-06-17,43,12198,1,279,1132823
2020-06-18,59,12257,1,280,1145712
2020-06-19,49,12306,0,280,1158063
2020-06-20,67,12373,0,280,1170901
2020-06-21,48,12421,0,280,1176463
2020-06-22,17,12438,0,280,1182066
2020-06-23,46,12484,1,281,1196012
2020-06-24,51,12535,0,281,1208597
2020-06-25,28,12563,1,282,1220478
2020-06-26,39,12602,0,282,1232315
2020-06-27,51,12653,0,282,1243780
2020-06-28,62,12715,0,282,1251695
2020-06-29,42,12757,0,282,1259954
2020-06-30,42,12799,0,282,1273765
2020-07-01,51,12850,0,282,1285231
2020-07-02,54,12904,0,282,1295962
2020-07-03,61,12965,0,282,1307759
2020-07-04,63,13028,1,283,1319521
2020-07-05,61,13089,0,283,1326055
2020-07-06,48,13137,1,284,1331796
2020-07-07,44,13181,1,285,1346194
2020-07-08,62,13243,0,285,1359734
2020-07-09,50,13293,2,287,1371771
2020-07-10,45,13338,1,288,1384890
2020-07-11,35,13373,0,288,1396941
2020-07-12,44,13417,1,289,1402144
2020-07-13,62,13479,0,289,1408312
2020-07-14,33,13512,0,289,1420616
2020-07-15,39,13551,0,289,1431316
2020-07-16,61,13612,2,291,1441348
2020-07-17,60,13672,2,293,1451017
2020-07-18,39,13711,1,294,1460204
2020-07-19,34,13745,1,295,1465299
2020-07-20,26,13771,1,296,1470193
2020-07-21,45,13816,0,296,1482390
2020-07-22,63,13879,1,297,1492071
2020-07-23,59,13938,0,297,1500854
2020-07-24,41,13979,1,298,1510327
2020-07-25,113,14092,0,298,1518634
2020-07-26,58,14150,0,298,1522926
2020-07-27,25,14175,1,299,1526974
2020-07-28,28,14203,1,300,1537704
2020-07-29,48,14251,0,300,1547307
2020-07-30,18,14269,0,300,1556215
2020-07-31,36,14305,1,301,1563796
2020-08-01,31,14336,0,301,1571830
2020-08-02,30,14366,0,301,1576246
2020-08-03,23,14389,0,301,1579757
2020-08-04,34,14423,0,301,1589780
2020-08-05,33,14456,1,302,1598187
2020-08-06,43,14499,0,302,1606487
2020-08-07,20,14519,1,303,1613652
2020-08-08,43,14562,1,304,1620514
2020-08-09,36,14598,1,305,1624650
2020-08-10,28,14626,0,305,1628303
2020-08-11,34,14660,0,305,1637844
2020-08-12,54,14714,0,305,1646652
2020-08-13,56,14770,0,305,1654898
2020-08-14,103,14873,0,305,1665084
2020-08-15,166,15039,0,305,1675296
2020-08-16,279,15318,0,305,1681787
2020-08-17,197,15515,0,305,1688470
2020-08-18,246,15761,1,306,1697042
2020-08-19,297,16058,0,306,1715064
2020-08-20,288,16346,1,307,1734083
2020-08-21,324,16670,2,309,1754123
2020-08-22,332,17002,0,309,1775800
2020-08-23,396,17398,0,309,1791186
2020-08-24,266,17664,0,309,1804422
2020-08-25,280,17944,1,310,1825837
2020-08-26,320,18264,2,312,1849506
2020-08-27,441,18705,1,313,1869579
2020-08-28,371,19076,3,316,1887717
2020-08-29,323,19399,5,321,1909329
2020-08-30,299,19698,2,323,1924170
2020-08-31,248,19946,1,324,1937689
2020-09-01,235,20181,0,324,1959080
2020-09-02,267,20448,2,326,1980295
2020-09-03,195,20643,3,329,2000552
2020-09-04,198,20841,2,331,2018906
2020-09-05,168,21009,2,333,2037045
2020-09-06,167,21176,1,334,2045935
2020-09-07,119,21295,2,336,2051297
2020-09-08,136,21431,5,341,2066078
2020-09-09,156,21587,3,344,2082234
2020-09-10,155,21742,2,346,2099591
2020-09-11,176,21918,4,350,2119211
2020-09-12,136,22054,5,355,2135457
2020-09-13,121,22175,3,358,2143270
2020-09-14,109,22284,5,363,2151002
2020-09-15,106,22390,4,367,2164578
2020-09-16,113,22503,0,367,2178832
2020-09-17,153,22656,5,372,2191892
2020-09-18,126,22782,5,377,2206365
2020-09-19,110,22892,1,378,2219162
2020-09-20,82,22974,5,383,2226701
2020-09-21,70,23044,2,385,2231589
2020-09-22,61,23105,3,388,2245112
2020-09-23,110,23215,0,388,2256899
2020-09-24,125,23340,5,393,2268999
2020-09-25,114,23454,2,395,2280276
2020-09-26,61,23515,4,399,2290345
2020-09-27,95,23610,2,401,2296517
2020-09-28,50,23660,5,406,2301303
2020-09-29,38,23698,1,407,2313044
2020-09-30,113,23811,6,413,2322999
2020-10-01,77,23888,2,415,2328435
2020-10-02,63,23951,1,416,2333777
2020-10-03,75,24026,4,420,2339859
2020-10-04,64,24090,1,421,2346345
2020-10-05,73,24163,1,422,2352378
2020-10-06,75,24238,0,422,2365433
2020-10-07,114,24352,3,425,2378073
2020-10-08,69,24421,2,427,2388844
2020-10-09,54,24475,1,428,2400233
2020-10-10,72,24547,2,430,2404684
2020-10-11,58,24605,2,432,2410483
2020-10-12,98,24703,1,433,2415610
2020-10-13,91,24794,1,434,2428760
2020-10-14,84,24878,4,438,2441443
2020-10-15,110,24988,1,439,2450739
2020-10-16,47,25035,2,441,2459426
2020-10-17,73,25108,2,443,2468527
2020-10-18,91,25199,1,444,2474529
2020-10-19,76,25275,0,444,2479226
2020-10-20,58,25333,3,447,2491311
2020-10-21,89,25422,3,450,2503489
2020-10-22,121,25543,3,453,2515325
2020-10-23,155,25698,2,455,2528621
2020-10-24,77,25775,2,457,2540679
2020-10-25,61,25836,0,457,2546146
2020-10-26,119,25955,0,457,2552264
2020-10-27,88,26043,3,460,2567587
2020-10-28,103,26146,1,461,2582960
2020-10-29,125,26271,1,462,2597978
2020-10-30,113,26384,1,463,2612231
2020-10-31,127,26511,1,464,2624492
2020-11-01,124,26635,2,466,2630630
2020-11-02,97,26732,2,468,2636650
2020-11-03,75,26807,4,472,2649859
2020-11-04,117,26924,2,474,2662259
2020-11-05,125,27049,1,475,2673705
2020-11-06,145,27194,1,476,2686313
2020-11-07,89,27283,1,477,2697248
2020-11-08,143,27426,1,478,2702879
2020-11-09,126,27552,2,480,2709198
2020-11-10,100,27652,5,485,2723959
2020-11-11,145,27797,2,487,2736532
2020-11-12,143,27940,0,487,2749770
2020-11-13,191,28131,1,488,2761409
2020-11-14,205,28336,4,492,2777287
2020-11-15,208,28544,1,493,2786876
2020-11-16,222,28766,1,494,2797689
2020-11-17,230,28996,0,494,2815753
2020-11-18,285,29281,2,496,2834332
2020-11-19,325,29606,2,498,2853795
2020-11-20,348,29954,3,501,2873380
2020-11-21,386,30340,2,503,2896683
2020-11-22,330,30670,2,505,2908827
2020-11-23,271,30941,4,509,2922072
2020-11-24,349,31290,1,510,2946336
2020-11-25,382,31672,3,513,2966342
2020-11-26,581,32253,2,515,2987982
2020-11-27,555,32808,1,516,3009499
2020-11-28,503,33311,6,522,3031940
2020-11-29,450,33761,1,523,3046908
2020-11-30,438,34199,3,526,3061170
2020-12-01,451,34650,0,526,3083995
2020-12-02,511,35161,0,526,3106968
2020-12-03,540,35701,3,529,3131884
2020-12-04,628,36329,7,536,3157407
2020-12-05,577,36906,4,540,3180487
2020-12-06,631,37537,5,545,3194858
2020-12-07,615,38152,4,549,3209367
2020-12-08,587,38739,3,552,3221316
2020-12-09,670,39409,4,556,3253219
2020-12-10,680,40089,8,564,3277946
2020-12-11,689,40778,8,572,3311211
2020-12-12,950,41728,6,578,3349862
2020-12-13,1030,42758,2,580,3374593
2020-12-14,718,43476,7,587,3397037
2020-12-15,880,44356,13,600,3441218
2020-12-16,1078,45434,12,612,3488767
2020-12-17,1014,46448,22,634,3538838
2020-12-18,1064,47512,11,645,3589795
2020-12-19,1045,48557,14,659,3646245
2020-12-20,1096,49653,15,674,3683091
2020-12-21,924,50577,24,698,3713856
2020-12-22,866,51443,24,722,3772425
2020-12-23,1090,52533,17,739,3826565
2020-12-24,985,53518,17,756,3882205
2020-12-25,1240,54758,17,773,3939352
2020-12-26,1131,55889,20,793,3969409
2020-12-27,970,56859,15,808,4006406
2020-12-28,806,57665,11,819,4038300
2020-12-29,1044,58709,40,859,4098173
2020-12-30,1050,59759,20,879,4159516
2020-12-31,967,60726,21,900,4213874
2021-01-01,1027,61753,17,917,4269312
2021-01-02,820,62573,25,942,4302792
2021-01-03,657,63230,20,962,4340832
2021-01-04,1020,64250,19,981,4376602
2021-01-05,714,64964,26,1007,4439354
2021-01-06,838,65802,20,1027,4504860
2021-01-07,869,66671,19,1046,4569802
2021-01-08,674,67345,35,1081,4629998
2021-01-09,641,67986,19,1100,4689610
2021-01-10,657,68643,25,1125,4723457
2021-01-11,451,69094,15,1140,4751679
2021-01-12,537,69631,25,1165,4814079
2021-01-13,561,70192,20,1185,4872306
2021-01-14,524,70716,10,1195,4925353
2021-01-15,512,71228,22,1217,4978068
2021-01-16,580,71808,19,1236,5032264
2021-01-17,520,72328,13,1249,5061284
2021-01-18,389,72717,15,1264,5087214
2021-01-19,386,73103,19,1283,5140320
2021-01-20,404,73507,17,1300,5192124
2021-01-21,400,73907,16,1316,5237602
2021-01-22,346,74253,12,1328,5282220
2021-01-23,431,74684,9,1337,5329704
2021-01-24,392,75076,12,1349,5354346
2021-01-25,437,75513,11,1360,5376083
2021-01-26,349,75862,11,1371,5422760
2021-01-27,559,76421,7,1378,5469244
2021-01-28,497,76918,8,1386,5522186
2021-01-29,469,77387,13,1399,5569261
2021-01-30,456,77843,15,1414,5616527
2021-01-31,354,78197,6,1420,5640817
2021-02-01,305,78502,5,1425,5661841
2021-02-02,336,78838,10,1435,5711412
2021-02-03,467,79305,6,1441,5756713
2021-02-04,451,79756,7,1448,5803094
2021-02-05,370,80126,11,1459,5847177
2021-02-06,390,80516,5,1464,5893352
2021-02-07,371,80887,7,1471,5916974
2021-02-08,288,81175,3,1474,5938195
2021-02-09,303,81478,8,1482,5987404
2021-02-10,444,81922,4,1486,6030022
2021-02-11,504,82426,10,1496,6070007
2021-02-12,403,82829,11,1507,6093368
2021-02-13,362,83191,7,1514,6115336
2021-02-14,326,83517,8,1522,6140085
2021-02-15,343,83860,5,1527,6162859
2021-02-16,457,84317,7,1534,6213489
2021-02-17,621,84938,4,1538,6260566
2021-02-18,621,85559,6,1544,6303213
2021-02-19,561,86120,6,1550,6345991
2021-02-20,448,86568,3,1553,6390630
2021-02-21,416,86984,4,1557,6411339
2021-02-22,332,87316,5,1562,6429143
2021-02-23,356,87672,11,1573,6472678
2021-02-24,440,88112,3,1576,6510987
2021-02-25,395,88507,5,1581,6551213
2021-02-26,387,88894,4,1585,6590065
2021-02-27,415,89309,10,1595,6627214
2021-02-28,355,89664,8,1603,6649005
2021-03-01,355,90019,2,1605,6665754
2021-03-02,344,90363,1,1606,6681975
2021-03-03,444,90807,6,1612,6716202
2021-03-04,424,91231,7,1619,6751899
2021-03-05,398,91629,8,1627,6789010
2021-03-06,418,92047,5,1632,6821942
2021-03-07,416,92463,2,1634,6843125
2021-03-08,346,92809,8,1642,6861808
2021-03-09,446,93255,3,1645,6902983
2021-03-10,470,93725,3,1648,6938883
2021-03-11,465,94190,4,1652,6976984
2021-03-12,488,94678,10,1662,7012663
2021-03-13,490,95168,5,1667,7046781
2021-03-14,459,95627,2,1669,7066400
2021-03-15,379,96006,6,1675,7084939
2021-03-16,363,96369,3,1678,7126076
2021-03-17,469,96838,8,1686,7171509
2021-03-18,445,97283,2,1688,7218086
2021-03-19,463,97746,2,1690,7264940
2021-03-20,447,98193,3,1693,7308949
2021-03-21,456,98649,3,1696,7332713
2021-03-22,415,99064,1,1697,7355963
2021-03-23,346,99410,7,1704,7400989
2021-03-24,428,99838,3,1707,7441209
2021-03-25,430,100268,2,1709,7485858
2021-03-26,489,100757,7,1716,7529401
2021-03-27,505,101262,5,1721,7572566
2021-03-28,482,101744,1,1722,7595594
2021-03-29,382,102126,4,1726,7616328
2021-03-30,447,102573,3,1729,7663997
2021-03-31,506,103079,2,1731,7707798
2021-04-01,551,103630,4,1735,7747301
2021-04-02,557,104187,2,1737,7788293
2021-04-03,543,104730,3,1740,7829599
2021-04-04,543,105273,4,1744,7849474
2021-04-05,473,105746,4,1748,7868818
2021-04-06,477,106223,4,1752,7921288
2021-04-07,668,106891,4,1756,7966165
2021-04-08,700,107591,2,1758,8012419
2021-04-09,671,108262,6,1764,8059111
2021-04-10,677,108939,1,1765,8106628
2021-04-11,614,109553,3,1768,8129530
2021-04-12,587,110140,2,1770,8152781
2021-04-13,542,110682,5,1775,8200517
2021-04-14,731,111413,7,1782,8245386
2021-04-15,698,112111,6,1788,8291124
2021-04-16,673,112784,2,1790,8333331
2021-04-17,658,113442,4,1794,8377778
2021-04-18,671,114113,3,1797,8396065
2021-04-19,532,114645,4,1801,8414820
2021-04-20,549,115194,1,1802,8458591
2021-04-21,731,115925,4,1806,8497593
2021-04-22,735,116660,2,1808,8537504
2021-04-23,797,117457,3,1811,8583529
2021-04-24,785,118242,1,1812,8632922
2021-04-25,644,118886,1,1813,8654790
2021-04-26,499,119385,4,1817,8672977
2021-04-27,512,119897,3,1820,8721608
2021-04-28,769,120666,1,1821,8766496
2021-04-29,679,121345,4,1825,8805778
2021-04-30,661,122006,3,1828,8848291
2021-05-01,627,122633,3,1831,8883387
2021-05-02,606,123239,2,1833,8898233
2021-05-03,488,123727,1,1834,8915325
2021-05-04,541,124268,6,1840,8957154
2021-05-05,676,124944,7,1847,8994068
2021-05-06,574,125518,4,1851,9010991
2021-05-07,525,126043,9,1860,9051353
2021-05-08,701,126744,5,1865,9089165
2021-05-09,564,127308,9,1874,9105770
2021-05-10,463,127771,1,1875,9122058
2021-05-11,510,128281,4,1879,9164283
2021-05-12,634,128915,5,1884,9201538
2021-05-13,715,129630,7,1891,9241152
2021-05-14,747,130377,2,1893,9281290
2021-05-15,681,131058,3,1896,9319093
2021-05-16,610,131668,4,1900,9336613
2021-05-17,619,132287,3,1903,9353299
2021-05-18,528,132815,1,1904,9395003
2021-05-19,654,133469,8,1912,9428643
2021-05-20,646,134115,4,1916,9447357
2021-05-21,561,134676,6,1922,9487107
2021-05-22,666,135342,4,1926,9520965
2021-05-23,585,135927,5,1931,9536298
2021-05-24,530,136457,3,1934,9553612
2021-05-25,516,136973,4,1938,9592726
2021-05-26,705,137678,2,1940,9629455
2021-05-27,629,138307,3,1943,9665690
2021-05-28,587,138894,3,1946,9702453
2021-05-29,533,139427,5,1951,9733588
2021-05-30,480,139907,6,1957,9747612
2021-05-31,430,140337,2,1959,9761156
2021-06-01,459,140796,4,1963,9798400
2021-06-02,677,141473,2,1965,9834348
2021-06-03,681,142154,3,1968,9872322
2021-06-04,695,142849,1,1969,9911322
2021-06-05,744,143593,2,1971,9945952
2021-06-06,556,144149,2,1973,9959695
2021-06-07,485,144634,1,1974,9972295
2021-06-08,454,145088,1,1975,10008582
2021-06-09,602,145690,2,1977,10044782
2021-06-10,610,146300,2,1979,10076861
2021-06-11,556,146856,2,1981,10111063
2021-06-12,565,147421,1,1982,10140534
2021-06-13,452,147873,3,1985,10152906
2021-06-14,399,148272,3,1988,10165496
2021-06-15,373,148645,4,1992,10196468
2021-06-16,545,149190,1,1993,10229383
2021-06-17,540,149730,1,1994,10257835
2021-06-18,507,150237,2,1996,10294047
2021-06-19,482,150719,1,1997,10323153
2021-06-20,429,151148,5,2002,10335633
2021-06-21,357,151505,2,2004,10346046
2021-06-22,394,151899,2,2006,10380042
2021-06-23,645,152544,1,2007,10409948
2021-06-24,610,153154,1,2008,10438781
2021-06-25,634,153788,1,2009,10466544
2021-06-26,668,154456,3,2012,10495515
2021-06-27,614,155070,1,2013,10508677
2021-06-28,501,155571,2,2015,10520928
2021-06-29,595,156166,2,2017,10555740
2021-06-30,794,156960,1,2018,10579071
2021-07-01,761,157721,3,2021,10614315
2021-07-02,825,158546,3,2024,10641601
2021-07-03,794,159340,1,2025,10670616
2021-07-04,743,160083,1,2026,10685124
2021-07-05,711,160794,2,2028,10700133
2021-07-06,746,161540,4,2032,10735715
2021-07-07,1211,162751,1,2033,10766500
2021-07-08,1275,164026,1,2034,10802780
2021-07-09,1316,165342,2,2036,10844215
2021-07-10,1378,166720,2,2038,10881638
2021-07-11,1324,168044,5,2043,10902276
2021-07-12,1100,169144,1,2044,10919896
2021-07-13,1150,170294,2,2046,10964297
2021-07-14,1613,171907,2,2048,11008857
2021-07-15,1599,173506,2,2050,11060454
2021-07-16,1535,175041,1,2051,11108582
2021-07-17,1449,176490,4,2055,11149223
2021-07-18,1453,177943,2,2057,11175977
2021-07-19,1251,179194,1,2058,11202429
2021-07-20,1278,180472,1,2059,11251982
2021-07-21,1781,182253,1,2060,11298669
2021-07-22,1841,184094,3,2063,11343913
2021-07-23,1629,185723,3,2066,11388299
2021-07-24,1627,187350,2,2068,11430518
2021-07-25,1487,188837,5,2073,11453340
2021-07-26,1318,190155,4,2077,11472339
2021-07-27,1363,191518,2,2079,11528602
2021-07-28,1895,193413,4,2083,11585607
2021-07-29,1673,195086,2,2085,11637500
2021-07-30,1710,196796,4,2089,11682962
2021-07-31,1538,198334,6,2095,11728815
2021-08-01,1442,199776,3,2098,11751780
2021-08-02,1218,200994,1,2099,11772599
2021-08-03,1200,202194,5,2104,11820011
2021-08-04,1725,203919,2,2106,11864240
2021-08-05,1775,205694,3,2109,11908430
2021-08-06,1704,207398,4,2113,11951646
2021-08-07,1823,209221,3,2116,11995923
2021-08-08,1727,210948,5,2121,12027437
2021-08-09,1491,212439,4,2125,12057824
2021-08-10,1537,213976,9,2134,12112079
2021-08-11,2221,216197,1,2135,12156192
2021-08-12,1987,218184,3,2138,12207035
2021-08-13,1989,220173,6,2144,12257959
2021-08-14,1928,222101,4,2148,12309273
2021-08-15,1816,223917,8,2156,12344711
2021-08-16,1554,225471,11,2167,12372769
2021-08-17,1372,226843,6,2173,12404969
2021-08-18,1803,228646,5,2178,12461676
2021-08-19,2152,230798,13,2191,12518695
2021-08-20,2140,232938,6,2197,12567090
2021-08-21,1787,234725,5,2202,12632591
2021-08-22,1626,236351,13,2215,12664332
2021-08-23,1417,237768,7,2222,12694018
2021-08-24,1507,239275,6,2228,12749751
2021-08-25,2154,241429,9,2237,12806608
2021-08-26,1882,243311,20,2257,12866797
2021-08-27,1837,245148,8,2265,12927789
2021-08-28,1791,246939,11,2276,12983486
2021-08-29,1619,248558,3,2279,13015921
2021-08-30,1485,250043,5,2284,13049678
2021-08-31,1370,251413,1,2285,13094711
2021-09-01,2024,253437,7,2292,13152140
2021-09-02,1960,255397,11,2303,13223511
2021-09-03,1708,257105,5,2308,13286677
2021-09-04,1803,258908,7,2315,13350356
2021-09-05,1490,260398,6,2321,13382733
2021-09-06,1375,261773,6,2327,13416743
2021-09-07,1597,263370,3,2330,13468412
2021-09-08,2047,265417,4,2334,13519664
2021-09-09,2049,267466,9,2343,13568869
2021-09-10,1893,269359,5,2348,13615055
2021-09-11,1864,271223,10,2358,13665460
2021-09-12,1755,272978,1,2359,13704173
2021-09-13,1433,274411,1,2360,13735740
2021-09-14,1508,275919,7,2367,13790239
2021-09-15,2065,277984,13,2380,13839087
2021-09-16,1942,279926,6,2386,13890499
2021-09-17,2008,281934,3,2389,13938955
2021-09-18,2087,284021,5,2394,13986615
2021-09-19,1909,285930,9,2403,14020498
2021-09-20,1604,287534,6,2409,14050974
2021-09-21,1729,289263,4,2413,14081284
2021-09-22,1720,290983,6,2419,14112435
2021-09-23,1715,292698,8,2427,14151069
2021-09-24,2429,295127,7,2434,14221682
2021-09-25,3270,298397,7,2441,14285337
2021-09-26,2768,301165,9,2450,14325932
2021-09-27,2381,303546,6,2456,14365928
2021-09-28,2288,305834,8,2464,14425565
2021-09-29,2881,308715,10,2474,14485251
2021-09-30,2561,311276,7,2481,14544246
2021-10-01,2484,313760,16,2497,14596211
2021-10-02,2247,316007,7,2504,14644685
2021-10-03,2085,318092,3,2507,14675115
2021-10-04,1670,319762,6,2513,14701211
2021-10-05,1574,321336,11,2524,14731627
2021-10-06,2027,323363,12,2536,14780938
2021-10-07,2425,325788,8,2544,14833965
2021-10-08,2171,327959,10,2554,14882186
2021-10-09,1953,329912,6,2560,14925863
2021-10-10,1594,331506,15,2575,14951646
2021-10-11,1297,332803,8,2583,14977407
2021-10-12,1346,334149,11,2594,15007572
2021-10-13,1583,335732,11,2605,15062412
2021-10-14,1939,337671,13,2618,15106360
2021-10-15,1683,339354,8,2626,15152521
2021-10-16,1617,340971,18,2644,15198187
2021-10-17,1420,342391,16,2660,15220864
2021-10-18,1050,343441,8,2668,15246346
2021-10-19,1073,344514,21,2689,15296830
2021-10-20,1571,346085,9,2698,15344729
2021-10-21,1441,347526,11,2709,15392004
2021-10-22,1438,348964,16,2725,15437382
2021-10-23,1508,350472,20,2745,15481469
2021-10-24,1421,351893,21,2766,15504979
2021-10-25,1190,353083,7,2773,15530472
2021-10-26,1272,354355,15,2788,15579430
2021-10-27,1945,356300,9,2797,15628306
2021-10-28,2111,358411,11,2808,15678186
2021-10-29,2121,360532,9,2817,15730782
2021-10-30,2104,362636,13,2830,15775697
2021-10-31,2061,364697,19,2849,15804062
2021-11-01,1685,366382,9,2858,15849300
2021-11-02,1588,367970,16,2874,15905185
2021-11-03,2667,370637,18,2892,15953526
2021-11-04,2482,373119,24,2916,16001231
2021-11-05,2343,375462,20,2936,16051667
2021-11-06,2246,377708,20,2956,16099185
2021-11-07,2225,379933,11,2967,16130872
2021-11-08,1754,381687,13,2980,16160828
2021-11-09,1717,383404,18,2998,16212870
2021-11-10,2425,385829,14,3012,16261877
2021-11-11,2518,388347,21,3033,16312771
2021-11-12,2368,390715,18,3051,16361028
2021-11-13,2324,393039,32,3083,16408598
2021-11-14,2418,395457,20,3103,16440427
2021-11-15,2004,397461,12,3115,16470969
2021-11-16,2122,399583,22,3137,16525384
2021-11-17,3189,402772,21,3158,16575880
2021-11-18,3292,406064,29,3187,16631273
2021-11-19,3033,409097,28,3215,16684168
2021-11-20,3205,412302,29,3244,16740119
2021-11-21,3120,415422,30,3274,16777679
2021-11-22,2827,418249,24,3298,16816616
2021-11-23,2697,420946,30,3328,16878955
2021-11-24,4113,425059,34,3362,16939923
2021-11-25,3937,428996,39,3401,16998733
2021-11-26,3896,432892,39,3440,17056003
2021-11-27,4067,436959,52,3492,17115754
2021-11-28,3925,440884,56,3548,17158535
2021-11-29,3307,444191,32,3580,17200325
2021-11-30,3031,447222,44,3624,17265258
2021-12-01,5122,452344,34,3658,17329295
2021-12-02,5263,457607,47,3705,17391434
2021-12-03,4944,462551,34,3739,17457487
2021-12-04,5352,467903,70,3809,17527015
2021-12-05,5125,473028,43,3852,17577570
2021-12-06,4324,477352,41,3893,17628218
2021-12-07,4953,482305,64,3957,17709512
2021-12-08,7173,489478,63,4020,17787657
2021-12-09,7375,496853,57,4077,17870821
2021-12-10,6748,503601,53,4130,17950721
2021-12-11,6977,510578,80,4210,18024403
2021-12-12,6681,517259,42,4252,18084589
2021-12-13,5816,523075,40,4292,18140572
2021-12-14,5567,528642,94,4386,18224740
2021-12-15,7849,536491,70,4456,18298675
2021-12-16,7619,544110,62,4518,18381569
2021-12-17,7434,551544,73,4591,18460563
2021-12-18,7310,558854,53,4644,18539009
2021-12-19,6233,565087,78,4722,18593165
2021-12-20,5316,570403,54,4776,18645857
2021-12-21,5192,575595,52,4828,18718803
2021-12-22,7452,583047,78,4906,18786344
2021-12-23,6914,589961,109,5015,18859285
2021-12-24,6233,596194,56,5071,18929158
2021-12-25,5840,602034,105,5176,18994820
2021-12-26,5413,607447,69,5245,19040194
2021-12-27,4203,611650,55,5300,19082135
2021-12-28,3864,615514,46,5346,19141481
2021-12-29,5407,620921,36,5382,19196738
2021-12-30,5034,625955,73,5455,19251165
2021-12-31,4873,630828,108,5563,19309072
2022-01-01,4415,635243,62,5625,19364122
2022-01-02,3831,639074,69,5694,19456900
2022-01-03,3125,642199,36,5730,19546883
2022-01-04,3021,645220,51,5781,19671880
2022-01-05,4441,649661,57,5838,19778824
2022-01-06,4122,653783,49,5887,19875047
2022-01-07,3713,657496,45,5932,19971712
2022-01-08,3507,661003,54,5986,20046220
2022-01-09,3371,664374,51,6037,20099870
2022-01-10,3005,667379,34,6071,20148476
2022-01-11,3092,670471,43,6114,20215297
2022-01-12,4383,674854,52,6166,20277357
2022-01-13,4164,679018,44,6210,20329715
2022-01-14,4538,683556,49,6259,20389154
2022-01-15,4419,687975,22,6281,20446099
2022-01-16,4189,692164,29,6310,20489023
2022-01-17,3854,696018,23,6333,20527722
2022-01-18,4062,700080,45,6378,20588481
2022-01-19,5803,705883,74,6452,20649522
2022-01-20,6600,712483,28,6480,20709568
2022-01-21,6766,719249,21,6501,20765930
2022-01-22,7004,726253,28,6529,20838500
2022-01-23,7626,733879,11,6540,20892539
2022-01-24,7511,741390,25,6565,20943638
2022-01-25,8570,749960,23,6588,21026346
2022-01-26,13009,762969,32,6620,21110639
2022-01-27,14514,777483,34,6654,21196354
2022-01-28,16093,793576,24,6678,21269304
2022-01-29,17513,811089,34,6712,21377393
2022-01-30,17522,828611,20,6732,21448119
2022-01-31,17077,845688,23,6755,21518073
